%%%%%
% . %
%...%
% . %
%. .%
%   %
%  .%
%o  %
%Po.%
%%%%%
